XXXXXXXXXXXXXXXXXXXXXXXXXXXXXXXXX
X--------------------------L----X
X-----P----------L--------------X
X-------------------------------X
XXXXXXXXXXXXXXXXXXXXXXXXXXXXX---XX
X-------------------L-------X----X
X---------------------------X----XX
X-------------G--------E----X----XX
X-----XXXX------------------X----XX
X--L--XXXX----S--------X----X----XX
X-----XXXX------L-----XX----X-L--XX
X-----====-----------XXX----X----XX
X---------E-----------------X----XX
X--------------------L------X----XX
X-----XXXXXXXX----XXXXXXXXXXX----XX
X-----XXXXXXXX-----XXXXXXXXXX----XX
X--------------L-----------L-----XX
X-----L-------------------------XX
XXXXXXXXXXXXXXXXXXXXXXXXXXXXXXXXX