XXXXXXXXXXXXXXXXXXXXXXXXXXXXX
X-------------E-------------X
X-----P---------------------X
X---------------------------X
X-------------------E-------X
X---------------------------X
X-------------G-------------X
X---------------------------X
X--------E------------------X
X---------------------------X
X---------------------------X
X-----E---------------------X
X--------------------E------X
XXXXXXXXXXXXXXXXXXXXXXXXXXXXX