XXXXXXXXXXXXXXXXXXXXXXXXXXXXXXXXX
X--------------------------------L----X
X----P-----------L--------------X
X------L------E----------L------X
XXXXXXX-------------XXXXXXXXXXXXXXX-----XX
X------------------L-------X----X
X-------E-------------------X----XX
X-------------------L-----E----X----XX
X-----XXXX------------------X----XX
X--L--XXXX----X--------X----X----XX
X-----XXXX------L-----XX----X-L--XX
X-----====-----------XXX----X----XX
X---------E-------------L---X----XX
X--------------------L------X----XX
X-----XXXXXXXX----XXXXXXXXXXX----XX
X-----XXXXXXXX-----XXXXXXXXXX----XX
X--------------L-----------L-----XX
X-----L-------------------------XX
XXXXXXXXXXXXXXXXXXXXXXXXXXXXXXXXX


Build your map! 
L- is a lamp
p- is where you start
X - is a wall
G is the ground
E is a surprise

Controls
WASD to walk around 
Walk into Lamps to collect
Enter to release Lamp
R to reload Scene